20
60
111111111111111111111111111111111111111111111111111111111111
100000000000000000000000000000000000000000000000000000000001
100000000000000000000000000000000000000000000000000000000001
100000000000000000000000000000000000000000000000000000000001
100000000000000000000000000000000000000000000000000000000001
100000000000000000000000000000000000000000000000000000000001
100000000000000000000000000000000000000000000000000000000001
100000000000000000000000000000000000000000000000000000000001
100000111110000000000000000000000000000000000000111111111111
100000000222000000000000000000000000000000000000000000000001
100000000033300000000000000000000000045011111111000000000001
100000000004665700000000000000000111000000000000000000000001
100000000000000000000000000075644000000000000000000000000001
100000000000000000000034512100000000000000000000000000000001
100000000000000000013100000000000000000000000000001000000001
100000000000003454200000000000000000000000000000000000000001
100001110000011100000000000000000000000001000000000000000001
100000000000000000000000011111111110000001000000000000000001
100000000000000000000000000000000000000001000000000000000001
111111111111111111111111111111111111111111111111111111111111