30
100
1111111111111111111111111111111111111111111111111111111111111111111111111111111111111111111111111111
0000000000000000000000000000000000000000000000000000000000000000000000000000000000000000000000000000
0000000000000000000000000000000000000000000000000000000000000000000000000000000000000000000000000000
0000000000000000000000000000000000000000000000000000000000000000000000000000000000000000000000000000
0000000000000000000000000000000000000000000000000000000000000000000000000000000000000000000000000000
0000000000000000000000000000000000000000000000000000000000000000000000000000000000000000000000000000
0000000000000000000000000000000000000000000000000000000000000000000000000000000000000000000000000000
0000000000000000000000000000000000000000000000000000000000000000000000000000000000000000000000000000
1111100011110100101100110011100011100001011000100110001010100011010110011010010101111110101111110111
2111211121110210211211210022101112100112112010110211112121201121020221112020120202112211212121211222
2112312131121320222311220023201113210113213121121311213122201132130232212020130203212222223131212333
3213423241221330332321331124302114210114314222231411314232202133230332312130141203312332334142322433
4214433241222330442332442225412115220224325222232512415342202244340343423130251303423443335252422534
5324533351322440452433552325412216320335436332332513526353213355341444423241252403423544335362423545
6435544351423450562433662325412226331345545433342513626454313365341554424341262413433654436463523655
6445554461533450663544553426512325442455646443452624535454424366442664524351353413434654535554624665
5556564452534460564644654426513325543556546553563624645464534356542565634452454413444654645565625656
6556555452634451564545564526624335543666656563654635555554635465543556645453565423554664656665626555
5656566563635562564646655535625346643555665653564545665655646466554656656564565523665555666566526556
6655655664635653554645566645636446553566656553565545666665656455565555555664555533665556556566536655
6565566564546553654556565645535446664556565554566546555665566456656555655555665533556655566655635566
5565655554545564565566565655645545654656665565565555665656656556566656555665655633656666655565535555
6556565564656655565666556665645545554556666555665666556556555566666566556555555644555555656656645565
6656556555666666655655565655655655555666655656666666556656655656566565555656565644655656665555656555
6655566566665656655666665566555665656565565666665655656666566556566555556565566645656566665565556565
5656666656565555555565565555655656556565555656555665566566655555666565566566656655555555555665666556
5665556555556655556565556566556565566556655665656666566566656565555555656656656565565656656566666565
6656656556656656656665565566566656665655556655656555656656566655656565666556665656565556656555565565
5666655655656555565555566566555566665565566655556555666656655656666555556666566655656565556656556566
1111111111111111111111111111111111111111111111111111111111111111111111111111111111111111111111111111
