30
100
11111111111111111111111111111111111111111111111111111111111111111111111111111111111111111111111111111
00000000000000000000000000000000000000000000000000000000000000000000000000000000000000000000000000001
00000000000000000000000000000000000000000000000000000000000000000000000000000000000000000000000000001
00000000000000000000000000000000000000000000000000000000000000000000000000000000000000000000000000001
00000000000000000000000000000000000000000000000000000000000000000000000000000000000000000000000000001
00000000000000000000000000000000000000000000000000000000000000000000000000000000000000000000000000001
00000000000000000000000000000000000000000000000000000000000000000000000000000000000000000000000000001
00000000000000000000000000000000000000000000000000000000000000000000000000000000000000000000000000001
00000000000000000000000000000000000000000000000000000000000000000000000000000000000000000000000000001
0000030150202300430053420122000220000004505552020004110040030504035100043340230401000100000005024040
4024220030510000203005120202120000040334524100240045032200310510015305003453330005025000440100410000
0004511040013110200034150000000504500200204300053350001230430000401131100011203135020232300044020200
5400004003420011050005435050004340040050401130020303441420000354502030002544220010104200050023300000
3000320101500300415410114044001000141011045002001001314050500030042010140103540020005302142540040040
0220050101215003405050003040340000503001032150040000300000002005000300201302350540005000550000051320
3004454000500000231000410004000040532042040000002000400003140152013210400000343540050000000010405000
0002031010500000335000202500040200002010400102203000000005510502001020105000230500303000010345000000
2301000050450003355344001050003003300514001005515041013200002000542005505400310152430002503211003000
0104150010313300002001030001020055020000332003530130401520540052000024040010424010003332220005301200
0041003140040044043110141010000014200534000300002404501205554013020031232000103040100000040010002200
0045002300104031520441100002002500052333003003013004150540100100001202354001313000300032001200440210
4002001053002545002400545040105022010510005002000050404120003320040402004005410004024033003510403500
0005023030000001402420330255222402130243030310431103004010545420000052040010423000501331025004502110
5000511001302101001411103310000500504000002000200000300020000045034055005122000500400540054151152020
5450130000510104003420500050000502402050000015021000020100002512203401002002200003505000541000002100
2024020353033540204004152435003004030120405010525230033050000530034000000002050033400300000003110130
0003300220402410000440500020300500305400344030300520502520030143525104520032023000205002421110405040
0500001000004025015104400202045050002002300542000021023054030320300305500023000033030100424004441030
0020302012005500101104100051303102500505000200532053503020304202330030001521542025005550022400442300
11111111111111111111111111111111111111111111111111111111111111111111111111111111111111111111111111111
