30
100
1111111111111111111111111111111111111111111111111111111111111111111111111111111111111111111111111111
0000000000000000000000000000000000000000000000000000000000000000000000000000000000000000000000000000
0000000000000000000000000000000000000000000000000000000000000000000000000000000000000000000000000000
0000000000000000000000000000000000000000000000000000000000000000000000000000000000000000000000000000
0000000000000000000000000000000000000000000000000000000000000000000000000000000000000000000000000000
0000000000000000000000000000000000000000000000000000000000000000000000000000000000000000000000000000
0000000000000000000000000000000000000000000000000000000000000000000000000000000000000000000000000000
0000000000000000000000000000000000000000000000000000000000000000000000000000000000000000000000000000
0001110110000111101110110110001111000100111100010010110100010110101000001100110001101011010100011011
1112121221010222202211210120011221110111211201110011120101011221111101111100121011111012110101111022
2213222222120323213221321231111221210222212202221121221211012222211212111110131011121112211211222122
2323333232130424224221422231111321210223222302332222232321023333222312121221241121131222212312222233
2333434332231524335221533332221431321233333403332333243322124343323322221232341121231333223413232334
3334534342341534335222643332232442331343333504433434243333235353434422321343341122241443334414233344
3434535343452645336323644342233452341454433505534535353434245464445523322453451223341444345414344454
3544546453452645345324555352334462442464534615535636463445355465556623433553462334351555456515354455
4544556563552546445425556453435552452564634626646545554545366566665633443664563335361555466526355456
5545665654663646545525655454446562452564634635545645664555455655666634443564554345351566556526455465
5555555565563545645535565564545562463554534546656645565656556655555634444664654346452565555525566566
5566665565554655655646565664546563553664634645666546566555656665666545454654564456562556556625555566
5656656655564655565646556665656664553555544555556546656555556656565545555664665556653665655636666666
6655565666665566566655556666556554563655655565565555566565556566565555655554665555564556566635565655
6666656655655665555665655565556665654565555566565655555565555666566655565555655556554565656545555556
5555565666556565565555655666666565665566665555665555666665665666665565656565666555565656666556656556
5556655556566556665565665665655566665656666656556655666555556566656666565566665555556555556666655656
6565566555665665565565566556666565556565666556655666565566566566556566666665656666665655655656665665
5665655666665566656665555555556565666655555555666556655665656655655666555655655655656566666566566666
5665655655566656565656656566665665555556556666666665555565665555665566565555566556666566655565666655
6555656656666656556566655555566665566655665656555665656565555666655566655566666555665566666565556656
1111111111111111111111111111111111111111111111111111111111111111111111111111111111111111111111111111
