30
100
1111111111111111111111111111111111111111111111111111111111111111111111111111111111111111111111111111
0000000000000000000000000000000000000000000000000000000000000000000000000000000000000000000000000000
0000000000000000000000000000000000000000000000000000000000000000000000000000000000000000000000000000
0000000000000000000000000000000000000000000000000000000000000000000000000000000000000000000000000000
0000000000000000000000000000000000000000000000000000000000000000000000000000000000000000000000000000
0000000000000000000000000000000000000000000000000000000000000000000000000000000000000000000000000000
0000000000000000000000000000000000000000000000000000000000000000000000000000000000000000000000000000
0000000000000000000000000000000000000000000000000000000000000000000000000000000000000000000000000000
1100011100110001001011000010111001001010001011111010000110011011000100111010110011010110010111010110
2110011100220001102012111021121002111120001022122010000221022012100201122120121011010110010211121110
2220022201330001202123122031122003221221001033232121100231133112100311123120232011021211111221222120
2220022201441011312134223042133104322232101044333221201242243122211422133130243121031222212321323220
3220033201542112313144333153133105322343112154334221301352344232221533233231343131142322312331433331
3330133212643222313155434253234115322344113265335321411363345332331534343241454132253323312432533332
3341244322554333414266534364334126422454124266345422411463445442341534353351454132363434313442644443
3452254432555344514365544454435235523555224256455523411564545443442635363352565243353445423543554454
4452354533665444525456545554446235533656235256456534521564556444452646354463556344354555434543555454
5553455633555545535466656554445345533666236256466634621565566544552546454554566345465656435553665555
6664455543655655536465555555556355633666235256466534531656566654662646564564566456466555446564556656
6654455543565655646565566565556355543666236365565644532656555655552555665665655566566556456554655556
6664465643566665646655556655556455653566245456566645533665566666563656565656666555665556455654666565
5554555654665555555666655555655555653666246465556645643665656666663556666556566565666656555654565555
5565655665555565565656665565665566664666245456555646654565566566554655655665665555565565655565666555
6666556655556655556655565665666666664656356565665645555565665656564666656656665566656556566665565655
6566666665666566565556566556656656564565366555666556556566556656665556656665666556665666656655665565
6556656655566565565655655565665566665665356555565566556665555655556665566656666665565556665655566656
5566555556666656656666665555665656566565355565656666656656666656555665666666655556656666566566556566
6555566566555555566556665555666556656665455555566655556666555655656565566655665566565565566656665555
5666565566655556665566556656566555655665456555665665665666655555565656666665556656555655566566655556
1111111111111111111111111111111111111111111111111111111111111111111111111111111111111111111111111111
