30
100
11111111111111111111111111111111111111111111111111111111111111111111111111111111111111111111111111111
00000000000000000000000000000000000000000000000000000000000000000000000000000000000000000000000000001
00000000000000000000000000000000000000000000000000000000000000000000000000000000000000000000000000001
00000000000000000000000000000000000000000000000000000000000000000000000000000000000000000000000000001
00000000000000000000000000000000000000000000000000000000000000000000000000000000000000000000000000001
00000000000000000000000000000000000000000000000000000000000000000000000000000000000000000000000000001
00000000000000000000000000000000000000000000000000000000000000000000000000000000000000000000000000001
00000000000000000000000000000000000000000000000000000000000000000000000000000000000000000000000000001
00000000000000000000000000000000000000000000000000000000000000000000000000000000000000000000000000001
0450023100440021005502005103000000150100404000155204005232000022505051113100102020003235135110030400
4334013042310034001101011042003050110110400000352300310404354400000005042000302010004325042304000000
0434400305500050311034000500240050252005524400104010400022425044023150203501053131110400100505010550
0014050000104002300130430430121000413135004010401010000050254020100110410300320100040001320111020040
0153000022104101300355040402000020004000050030000000040050040400520013403005120005200221253000000040
1350552224221000035102201410334030450400002040000420300500020000000302100000322004000010550350203500
5200200430050030000000003000000415010522005000000010000301035030304250000014521503001100504400500400
0410040334002035000000101303001230003024200002010330502053042045005050024533030001150054013000102410
0000010020404550100204200005012040302154304003403100542005050000523200012000501134553000530013401140
0000030003100140400405120300400000110000200004000455424043540350252004044000000000000250400050250100
3250004042033000022253034450000010010010000050001504302020500222340040020323003000004440303500355000
4400001000031052000130040050030050400310330000053020023204205530000400005354033000030152424041002500
4000023500002050400000423214014002003440052010300001005010400340300021203203413304000040440004505400
0000140240550000010320001010101230353030124101052030013000431005305013004001200250550030302200552100
0411000200200051030001000023203201100240033115020530500350154302400233021001000530400032205451410400
0540010300150400001000302452500040200001052210040040200320025000430300552220403200003241121100001100
0525330203230100220042303304220304041053304004000525002001300054023040003001000201003202051003200050
0202221205030500513040533002010000010001020000125200011404404000500044000050330104500023000511020000
5401530202400553551542020014004442010501403142204402102240000304010000010130000041103044003051400210
4445500205443051504405030400003500053000004300000012000050222033430000115050200425050030003002240300
11111111111111111111111111111111111111111111111111111111111111111111111111111111111111111111111111111
