30
100
11111111111111111111111111111111111111111111111111111111111111111111111111111111111111111111111111111
00000000000000000000000000000000000000000000000000000000000000000000000000000000000000000000000000001
00000000000000000000000000000000000000000000000000000000000000000000000000000000000000000000000000001
00000000000000000000000000000000000000000000000000000000000000000000000000000000000000000000000000001
00000000000000000000000000000000000000000000000000000000000000000000000000000000000000000000000000001
00000000000000000000000000000000000000000000000000000000000000000000000000000000000000000000000000001
00000000000000000000000000000000000000000000000000000000000000000000000000000000000000000000000000001
00000000000000000000000000000000000000000000000000000000000000000000000000000000000000000000000000001
00000000000000000000000000000000000000000000000000000000000000000000000000000000000000000000000000001
0000000022000000004000050000040003100000000002050000010000200000000102001001330000000043001300210000
4000000000000002000000000000001000300000005210000000000210000000000000000040000004050002300500000000
0504000010040000400020000110004001010000000054000000000030000503050000025031000013000000000000020000
0000200000020000100000000000000000100300200003000000000001010000010000020300000100000000000000000000
0005000302000300050202000010522304003000040000050001200000000000300002102000000220005000000040010300
0300300000000000000500000000000000003032000000200000000000000050000400001000003000020000010000000010
0010000000000001000400000000000041200000000000000000002000001000301000030000000300000200000000004000
2100001000000001000000105100230320000000000001200000003040040000014040030050000050000000000010000000
1000000000000000002000300010000030010010000040220020015000050000300012000000000250000300001200000000
0000404000000030000000000000200400000000030000000000000105000000030000000000000003000004040000020000
4000000000000001000005001000000003001000400300000001000012000000000010000000000000004050000000000000
0000000000000000000030210000000030000000000000000003000500000020400000050000000000000000000000200230
2100002010101030000000320000315222300002031000000000220000050011003000214002000020000003020134204000
0300001000003310012005000000010000000000200220000010400000000010002200050020000000002000000000000000
0000021000000002000020004042001002301202101400200000050002000100000300000200004000000040002503000020
1030000000402000300010000000000200000000500003030300000002300030000000400300030400000000000000300000
0000000010020003050000000000033002200000502000100010000000000000220000000500000000000000000030000030
0000000200000000000010030000000501010001002000200010000020002000320000100000033000300103020010104000
0100000001110000000000000000004003301000000000000200001000100000000001020000000010010000000000002010
0300032200002400003200000000000003101003400000000000400002050030510000000501000000004005200300000000
11111111111111111111111111111111111111111111111111111111111111111111111111111111111111111111111111111
