50
100
0000000000000000000000000000000000000000000000000000000000000000000000000000000000000000000000000000
0000000000000000000000000000000000000000000000000000000000000000000000000000000000000000000000000000
0000000000000000000000000000000000000000000000000000000000000000000000000000000000000000000000000000
0000000000000000000000000000000000000000000000000000000000000000000000000000000000000000000000000000
0000000000000000000000000000000000000000000000000000000000000000000000000000000000000000000000000000
0000000000000000000000000000000000000000000000000000000000000000000000000000000000000000000000000000
0000000000000000000000000000000000000000000000000000000000000000000000000000000000000000000000000000
0000000000000000000000000000000000000000000000000000000000000000000000000000000000000000000000000000
0000000000000000000000000000000000000000000000000000000000000000000000000000000000000000000000000000
0000000000011000000000000000000000000000010000000000000000000000000000110000000000000000000000001100
0000000011111100000000000000000000000001111000000000000000000000000011111000000000000000000011111111
0000001111111111110000000000000000000011111100000000000000000000001111111111100000000000001111111111
0000111111111111111100000000000000000111111111111000000000000111111111111111110000000000011111111111
0001111111111111111111100000000000001111111111111100000000111111111111111111111000000000111111111111
0011111111111111111111110000000011111111111111111110000001111111111111111111111110001111111111111111
1111111111111111111111111111111110000000001000000000111111100011111111111111111111111111111111111111
1111111111111111111111111111111110000000000001000111111100000011111111111111111111111111111111111111
1111111111111111111111111111111110000000000001000000000111100000011111111111111111111111111111111111
1111111111111111111111111111111111111110000000001111000000000000000011111111111111111111111111111111
1111111111111111111111111111111111111111110000000000000000000000000000111111111111111111111111111111
1111111111111111111111111111111111111111110000001000000111111100011111111111111111111111111111111111
1111111111111111111111111111111111111111111000000000001111111100000000011111111111111111111111111111
1111111111111111111111111111111111111111111111111110001100000000000011111111111111111111111111111111
1111111111111111111111111111111111111111111111111111111100011111111111111111111111111111111111111111
1111111111111111111111111111111111111111111111111111100000011111111111111111111111111111111111111111
1111111111111111111111111111111111111111111111111111111111111111111111111111111111111111111111111111
1111111111111111111111111111111111111111111111111111111111111111111111111111111111111111111111111111
1111111111111111111111111111111111111111111111111111111111111111111111111111111111111111111111111111
1111111111111111111111111111111111111111111111111111111111111111111111111111111111111111111111111111
1111111111111111111111111111111111111111111111111111111111111111111111111111111111111111111111111111
1111111111111111111111111111111111111111111111111111111111111111111111111111111111111111111111111111
1111111111111111111111111111111111111111111111111111111111111111111111111111111111111111111111111111
1111111111111111111111111111111111111111111111111111111111111111111111111111111111111111111111111111
1111111111111111111111111111111111111111111111111111111111111111111111111111111111111111111111111111
1111111111111111111111111111111111111111111111111111111111111111111111111111111111111111111111111111
1111111111111111111111111111111111111111111111111111111111111111111111111111111111111111111111111111
1111111111111111111111111111111111111111111111111111111111111111111111111111111111111111111111111111
1111111111111111111111111111111111111111111111111111111111111111111111111111111111111111111111111111
1111111111111111111111111111111111111111111111111111111111111111111111111111111111111111111111111111
1111111111111111111111111111111111111111111111111111111111111111111111111111111111111111111111111111
1111111111111111111111111111111111111111111111111111111111111111111111111111111111111111111111111111
1111111111111111111111111111111111111111111111111111111111111111111111111111111111111111111111111111
1111111111111111111111111111111111111111111111111111111111111111111111111111111111111111111111111111
1111111111111111111111111111111111111111111111111111111111111111111111111111111111111111111111111111
1111111111111111111111111111111111111111111111111111111111111111111111111111111111111111111111111111
1111111111111111111111111111111111111111111111111111111111111111111111111111111111111111111111111111
1111111111111111111111111111111111111111111111111111111111111111111111111111111111111111111111111111
1111111111111111111111111111111111111111111111111111111111111111111111111111111111111111111111111111
1111111111111111111111111111111111111111111111111111111111111111111111111111111111111111111111111111
1111111111111111111111111111111111111111111111111111111111111111111111111111111111111111111111111111
