30
100
11111111111111111111111111111111111111111111111111111111111111111111111111111111111111111111111111111
00000000000000000000000000000000000000000000000000000000000000000000000000000000000000000000000000001
00000000000000000000000000000000000000000000000000000000000000000000000000000000000000000000000000001
00000000000000000000000000000000000000000000000000000000000000000000000000000000000000000000000000001
00000000000000000000000000000000000000000000000000000000000000000000000000000000000000000000000000001
00000000000000000000000000000000000000000000000000000000000000000000000000000000000000000000000000001
00000000000000000000000000000000000000000000000000000000000000000000000000000000000000000000000000001
00000000000000000000000000000000000000000000000000000000000000000000000000000000000000000000000000001
00000000000000000000000000000000000000000000000000000000000000000000000000000000000000000000000000001
0050042030034020000215401035043231510401050301401015033225300400030420350310000100050305001502101050
5400240040001020500200520000500503000003002005340050013543101030032000215025200031030504200445134500
4020410040040000000141000004401415402100004310041040250000102200153400000200002040022100053050123000
1200345000343001240400500104004302200110101040000040102034230000514054231234550350031340241300010500
0155310021000405034052001311055410020041204100334040500300000000040100005004000500100103400030230150
0333443310505003302201300213014000300040040020002004302333500020001053001200002030005111035400000130
0504200300053240000323502400300003050003002000010050131003000000000005000300020030333431500002240500
4050000005040031104450110031032402452002210010003400000000000153000200000005000200250053000300421500
0020000202211310130450004100304035001055002301030102120003541000503222031005111340452034515045001010
4001300254010015004002005510004300101210000000023505045000110000120015050103514535002020000000000050
2005550000001003011002122332101200030000000100015005022000540503000002010102025330020443400100520020
0000135215022045000040002140000200003003500511300002010001053005104032000454120135010055020100203520
0050200001002034300504350000402040020240552510200323430000125301045001110500250000332501352005330200
5000020000001040055002001000204040000525000400305025004400200052000000430100515204100200204500032540
0135001135000000350025100400515003025550001450050300052011055000000044003000442001114310330003005040
1000050210002220100550250001304204312300000304051400504030050500302005040000004045000042005050100100
3002340200500050031222200000400000040052201042230505004003005400040000350302000004504150400005005220
0040033100200200052003501000211130030002002431201040324001300505200000020501505030000230020002015110
2505002510040040505200340400050000440010030430140304134200402500002035500400005035100305440320300000
5310250350005004203040004030300100001000032300030014000311120010151430040000304220502053510053030300
11111111111111111111111111111111111111111111111111111111111111111111111111111111111111111111111111111
