30
100
1111111111111111111111111111111111111111111111111111111111111111111111111111111111111111111111111111
0000000000000000000000000000000000000000000000000000000000000000000000000000000000000000000000000000
0000000000000000000000000000000000000000000000000000000000000000000000000000000000000000000000000000
0000000000000000000000000000000000000000000000000000000000000000000000000000000000000000000000000000
0000000000000000000000000000000000000000000000000000000000000000000000000000000000000000000000000000
0000000000000000000000000000000000000000000000000000000000000000000000000000000000000000000000000000
0000000000000000000000000000000000000000000000000000000000000000000000000000000000000000000000000000
0000000000000000000000000000000000000000000000000000000000000000000000000000000000000000000000000000
1011101011000101000111101001100110101011001001001101001111010111110010000111011111000101000011010101
2111102021111212000221101111101220211121101002101111012112120112211010100222112222010212010011110112
3211102121121312111321201112201230312222201113211221122213221222321020111222213222010213110011110213
3312213121122422212431302222201241322322311223321321133223331233322030222232223323120314120111220323
4412224221232523322441413222202242433423311234331322233323432244323141232242324333120325230211230333
4512224322232633432452414322203253443533312344441422334423433255324152343252334443220326341221240344
4523225422332543443552515422304353553634312345541423335523443355324153343253344454330335451222250444
5533336433332654443663615532305454563635413445641434436524453455425164353263454564440446561332251455
5533336443343564543654525633316554663646513456642445536524564565435164364253454554551555651442351466
5544435544344665554554635644415664564556524455652446535535554555446164365354454654651565652542351455
5545536555344565555554635545525565665556524466562546636546565565546264456365454664662555553552361465
6556636555355566656564636545526655656566635555662555636645666565545365455465464554652555564652361565
6656645665366556666664536555636666556566535665563555545645556666545465465555554565552665565653462665
6555656656456565565654635665535556666565636666563555646556565565646456556556555655553566566664452666
5566565566456655565565636565535665666655545555554566645555556555656465555555555666663666655655463555
6555665666566655555666535665636656655665555655564666546565556666655455565566656565563555566666563556
6666566555565655666555636555546655556566655666664655655566556656656466655555656665554555556665654665
5565566555566556665656646666646655666555666565555665666665666666556465555565555565564555656656665655
5666556555565566566556655556656566655566656555565656566566556666655456656655566666665566556656655565
5565655666665655566666656656555656656655555666555556555665666666555455666655666665566566556665666665
5666565656555666565655566665556565555655566555656556666666665656655466655665666556656666665666556656
1111111111111111111111111111111111111111111111111111111111111111111111111111111111111111111111111111
