30
100
11111111111111111111111111111111111111111111111111111111111111111111111111111111111111111111111111111
00000000000000000000000000000000000000000000000000000000000000000000000000000000000000000000000000001
00000000000000000000000000000000000000000000000000000000000000000000000000000000000000000000000000001
00000000000000000000000000000000000000000000000000000000000000000000000000000000000000000000000000001
00000000000000000000000000000000000000000000000000000000000000000000000000000000000000000000000000001
00000000000000000000000000000000000000000000000000000000000000000000000000000000000000000000000000001
00000000000000000000000000000000000000000000000000000000000000000000000000000000000000000000000000001
00000000000000000000000000000000000000000000000000000000000000000000000000000000000000000000000000001
00000000000000000000000000000000000000000000000000000000000000000000000000000000000000000000000000001
0005002300034100031000000000440500344355304000150500121040010020424502010020500020052003405010000110
4335015045120410055024144123132004002340102000004002010334045220405500040300020150052000000250313050
0400000550351500202540030000235400212033402004100000001041510530035000005000410104200520000000001530
5050000030010005530302012400340000130042355352000030330230200252303003241331200214021000100141402030
0004002022020050000013030440200504053000210404003001032100550003250015020400142140200500550400100320
0001331033035404000030052050002303500140052035050050042050100110314115433100404031022002005102245000
2530315015300302030304002001513000511230441215302030041402000110302200305343130000100534005004100010
5052002005101023023403103025300002201504241340000043032000033200502050151230511020434440005301044000
0305030031035023314002024000055001004040152001101030550000200003400003051404014020002450300000052000
3040020504043130513030341032140100003235005000200002014210040101225442140323234005500410014000005100
0000000014050005000500020020530543000400002524233012050520044002000300200105530400230400120245004540
0130305040013002340301400150140255050450331004001100350501001155410000043200003040000202005004300000
0003004100435433004100410020040322005200305525033030101032000001521532004304000235120020402011045150
0020040500042323014005000001054310202450110302012000000030330002003440200400431003033102055412505420
1552303100140040005014004050010002050500000100001502521004002355502514103413500330003230240320010000
0323550020005513005054350043000110513000020312200011004531100302530401121000000403051000533402045510
0200000400001000005100403005000000050000040010402410003315040311051001022000010030002202000052013020
1440020244004500000002042130455300440005000204000430302400010005005000301455050003513002030444103300
5020201020000005400040530005000530200155302401230002000505004003231031025300302001005003000030430450
4000200000010140200030051450000001020350020040305004000000430000133051002100002022202012200450420010
11111111111111111111111111111111111111111111111111111111111111111111111111111111111111111111111111111
